{
    "tileSet": {
        "contentPath": "images/atlas",
        "region": {
            "name": "dungeon-01",
            "x": 260,
            "y": 0,
            "width": 80,
            "height": 80
        },
        "tileWidth": 20,
        "tileHeight": 20
    },
    "tiles": [
        ["00",  "01",  "02",  "01",  "02",  "01",  "02",  "01",  "02",  "01",  "02",  "01",  "02",  "01",  "02",  "03"],
        ["04",  "05",  "05",  "06",  "05",  "05",  "06",  "05",  "05",  "06",  "05",  "05",  "06",  "05",  "05",  "07"],
        ["08",  "09",  "09",  "09",  "09",  "09",  "09",  "09",  "09",  "09",  "09",  "09",  "09",  "09",  "09",  "11"],
        ["04",  "09",  "09",  "09",  "09",  "09",  "09",  "09",  "10",  "09",  "09",  "09",  "09",  "10",  "09",  "07"],
        ["08",  "09",  "10",  "09",  "09",  "09",  "09",  "09",  "09",  "09",  "09",  "09",  "09",  "09",  "09",  "11"],
        ["04",  "09",  "09",  "09",  "09",  "09",  "09",  "09",  "09",  "09",  "09",  "09",  "09",  "09",  "09",  "07"],
        ["08",  "10",  "09",  "09",  "09",  "09",  "09",  "09",  "09",  "09",  "10",  "09",  "09",  "09",  "09",  "11"],
        ["04",  "09",  "09",  "09",  "09",  "09",  "10",  "09",  "09",  "09",  "09",  "09",  "09",  "09",  "09",  "07"],
        ["12",  "13",  "14",  "13",  "14",  "13",  "14",  "13",  "14",  "13",  "14",  "13",  "14",  "13",  "14",  "15"]
    ]
}
